|--------------------------------------------|
|----------------------p---------------------|
|                                            |
|      .                                     |
i     / \                     .              |
|     |_|      WWWWWWWWWWW   / \             |
|              W         W   |_|             |
|    CC        W  #####  W                   o
|    CC        W  #####  W                   |
|              W  #####  W   CC              |
|              W         W   CC              |
|       .      WWWWWWWWWWW                   |
|      / \                                   |
|      |_|         CC            .           |
|                  CC           / \          |
|                        .      |_|          |
|                       / \                  |
|                       |_|                  |
|                                            |
|--------------------------------------------|
|--------------------------------------------|
